15
10
#|#|#|#|#|#|#|#|#|#|
#|_|_|_|a|_|_|#|_|_|
#|_|_|_|#|_|_|a|_|_|
#|_|_|_|#|_|_|#|_|_|
#|_|_|_|a|_|_|#|_|_|
#|a|#|#|#|#|a|#|#|#|
#|_|_|_|#|_|_|_|_|#|
#|_|_|_|#|_|_|_|_|#|
#|_|_|_|a|_|_|_|_|#|
#|#|a|#|#|#|#|#|a|#|
#|_|_|_|a|_|_|#|_|_|
#|_|_|_|#|_|_|#|_|_|
#|_|_|_|#|_|_|a|_|_|
#|_|_|_|#|_|_|#|_|_|
#|_|_|_|#|_|_|#|_|_|
