#|#|#|#|#|#|#|#|#|#|#|#|~|~|~|~|~|#
#|_|_|_|_|_|_|_|_|_|%|%|~|~|~|~|~|#
#|_|$|$|_|_|_|_|_|_|%|%|_|_|_|$|$|#
#|_|$|$|#|#|#|_|#|_|#|#|_|#|_|_|_|#
#|_|_|_|#|_|#|_|E|_|#|#|_|#|_|_|_|#
#|_|_|_|c|_|#|_|#|_|#|#|_|a|_|_|_|#
#|_|_|_|c|_|#|_|#|_|#|#|_|a|_|_|_|#
#|_|_|_|#|_|#|_|#|_|#|#|_|#|_|_|_|#
#|_|_|_|#|_|#|_|#|_|#|#|_|#|_|*|*|#
#|_|_|_|#|_|#|_|#|#|#|#|#|#|_|_|_|#
#|&|&|_|_|'|'|_|_|_|_|_|!|!|_|_|_|#
#|&|&|_|_|'|'|_|_|_|_|_|!|!|_|_|_|#
#|#|#|#|#|#|#|#|#|#|#|#|#|#|#|#|#|#