15
10
#|#|#|#|#|#|#|#|#|#|
#|_|$|!|a|!|!|#|_|_|
#|!|$|_|#|!|!|a|_|_|
#|!|$|_|#|!|!|#|_|_|
#|!|!|_|#|$|!|#|_|_|
#|a|#|#|#|#|a|#|#|#|
#|!|$|!|#|%|_|O|N|#|
#|&|$|!|#|%|_|$|S|#|
#|&|!|!|c|%|_|$|S|#|
#|#|a|#|#|#|#|#|a|#|
#|_|&|&|a|&|&|#|S|_|
#|_|_|_|#|!|&|#|S|_|
#|_|_|_|#|!|&|a|O|_|
#|_|_|_|#|_|_|#|_|_|
#|_|_|_|#|_|_|#|_|_|