15
10
#|#|#|#|#|#|#|#|#|#|
#|!|!|_|a|_|_|#|_|_|
#|!|%|%|#|_|_|a|_|_|
#|!|%|%|#|_|_|#|_|_|
#|!|_|_|a|_|_|#|_|_|
#|c|#|#|#|#|a|#|#|#|
#|_|_|%|#|!|_|_|_|#|
#|_|!|%|#|!|%|_|_|#|
#|_|!|_|a|_|%|_|_|#|
#|#|a|#|#|#|#|#|a|#|
#|_|_|_|a|_|_|#|_|_|
#|_|_|_|#|_|_|#|_|_|
#|_|_|_|#|_|_|a|_|_|
#|_|_|_|#|_|_|#|_|_|
#|_|_|_|#|_|_|#|_|_|
